NO ./textures/wood.xpm
SO ./textures/default_cobble.xpm  
WE ./textures/default_stone.xpm
EA ./textures/wood.xpm

F 96,59,42
C 225,30,0

         111111111111111111111111
        1000000000111100000000001
        101100000000000D000000001
        1001000000011100000000W01
111111111011000001110000000000001
100000000000000001110111111111111
11110111111111011100000010001
11110111111111011101010010001
11000000110101011100000010001
10000000000000000000000010001
10000000000000001101010010001
11000001110101011111011110011
11110111 1110101 101111010001
11111111 1111111 111111111111