SO ./textures/south.xpm  
NO ./textures/north.xpm
EA ./textures/east.xpm
WE ./textures/west.xpm

C 225,30,0
F 220,100,0


1111111111 11111111111111        1111111111111111111111111
1000000001110000000000001        1000000000110000000000001
1011000000000000000000011        1011000000000000000000011
111111111110000000000001        1100000000000000000000001
          10000011100001111111111000000000000000000000001111 111
1111111111100000000000000000000000000000000000000000000N1    101
1000000000000001110011111111111101111111110111000000111111   111
100000000000000000001    11110111111111011101010010001
1000000011111000111011111110001100000011010101110000011111
100000001   100010100000010001000000000000000110000000000011111
1000000011111000101000000100010000000000000001101010000001
1000001000000000111000000100011000001110101011111011110011
1000000000000011110000001000111110111 1110101 101111010001
111111111111111 111111111111111111111 1111111 111111111111111