SO ./textures/south.xpm  
NO ./textures/north.xpm
EA ./textures/east.xpm
WE ./textures/west.xpm

C 225,30,0
F 220,100,0

11111111111111111
10000010000000001
10000000001000001
10000010000000001
10000000000N00001
11111111111111111