NO ./textures/north.xpm
SO ./textures/south.xpm  
WE ./textures/west.xpm
EA ./textures/east.xpm

F 220,100,0
C 225,30,0

1111111111111111111111111111
1000000000000000000001011111
10000000000000000000101010111111111
11111111111111111111111111111111111
111111111111111111000000000111111111
1000000000000000000000000110011111111111
111111111111111111111111111111
